..........
......O...
..O.......
.....O....
..........
O.........
....XO....
.Y.......O
.O........
...O......