.........Y
......O...
..O.......
.....O....
..........
O.........
....XO....
.........O
.O........
...O......